5 x 10
**********
* +*   R *
* H * *  *
*    * R *
**********