5 x 10
**O****O**
* +*   R *
* H * *  *
*    * R *
*****O****