5 x 10
**O****O**
* +*   R *
* H * *  *
O    * R *
*****O****